<map name="Maze1S" width="32" height="32">
	<tileinfo texture="pathfind.png" w="40" h="40">
		<tile index="0" x="40" y="0" blocking="false" cost="0" damping="2.0"/>
		<tile index="1" x="80" y="0" blocking="true" cost="0" damping="2.0"/>
		<tile index="2" x="120" y="0" blocking="false" cost="0" damping="4.0"/>
		<tile index="3" x="160" y="0" blocking="false" cost="0" damping="2.0"/>
		<tile index="4" x="200" y="0" blocking="false" cost="0" damping="2.0"/>
		<tile index="5" x="240" y="0" blocking="false" cost="0" damping="2.0"/>
	</tileinfo>
	<tiles>
		1 1 1 1 1 1 1 1 1 1 1 1 1 1 1 1 1 1 1 1 1 1 1 1 1 1 1 1 1 1 1 1 
		1 3 3 3 3 3 3 3 3 3 3 3 3 3 3 3 3 3 3 3 3 3 3 3 1 3 3 3 3 3 3 1 
		1 3 0 0 0 0 0 0 0 0 0 0 0 0 0 0 0 0 0 0 0 0 0 0 1 3 0 0 0 0 0 1 
		1 1 1 1 1 1 1 1 1 1 5 0 0 1 1 1 1 1 1 1 1 5 0 0 1 3 0 1 1 5 0 1 
		1 3 3 3 3 3 3 3 3 3 3 0 0 4 3 3 3 3 3 3 3 3 0 0 1 3 0 1 1 3 0 1 
		1 3 0 0 0 0 0 0 0 0 0 0 0 0 0 0 0 0 0 0 0 0 0 0 1 3 0 4 3 3 0 1 
		1 3 0 0 1 1 1 1 1 1 1 1 1 1 1 5 0 0 0 0 0 1 5 0 1 3 0 0 0 0 0 1 
		1 3 0 0 1 3 3 3 3 3 3 3 3 3 1 3 0 0 0 0 0 1 3 0 1 1 1 5 0 1 1 1 
		1 3 0 0 1 3 0 0 0 0 0 0 0 0 1 3 0 0 1 1 1 1 3 0 1 1 1 3 0 4 3 1 
		1 3 0 0 1 3 0 0 1 5 0 0 0 0 1 3 0 0 4 3 3 3 3 0 4 1 1 3 0 0 0 1 
		1 3 0 0 1 3 0 0 1 3 0 0 1 1 1 3 0 0 0 0 0 0 0 0 0 4 1 1 1 5 0 1 
		1 3 0 0 1 3 0 0 1 3 0 0 1 1 1 3 0 0 1 1 1 1 1 1 5 0 4 1 1 3 0 1 
		1 3 0 0 1 3 0 0 1 3 0 0 4 3 3 3 0 0 1 3 3 3 3 3 1 5 0 4 3 3 0 1 
		1 3 0 0 1 3 0 0 1 3 0 0 0 0 0 0 0 0 1 3 0 0 0 0 4 1 5 0 0 0 0 1 
		1 3 0 0 1 3 0 0 1 3 0 0 0 0 0 0 0 0 1 3 0 1 5 0 0 4 1 5 0 0 0 1 
		1 3 0 0 1 3 0 0 1 1 1 1 1 1 1 1 1 1 1 3 0 1 1 5 0 0 1 1 1 5 0 1 
		1 3 0 0 1 3 0 0 4 3 3 3 1 3 3 3 3 3 3 3 0 4 3 3 0 0 4 3 3 3 0 1 
		1 3 0 0 1 3 0 0 0 0 0 0 1 3 0 0 0 0 0 0 0 0 0 0 0 0 0 0 0 0 0 1 
		1 3 0 0 1 3 0 0 0 0 0 0 1 3 0 0 0 0 0 0 0 1 1 1 5 0 0 0 0 0 0 1 
		1 3 0 0 1 1 1 1 1 5 0 0 1 3 0 0 1 1 1 1 1 1 1 1 1 1 1 1 1 5 0 1 
		1 3 0 0 1 3 3 3 3 3 0 0 1 3 0 0 4 3 1 3 3 3 1 3 3 3 3 3 1 3 0 1 
		1 3 0 0 1 3 0 0 0 0 0 0 1 3 0 0 0 0 4 3 0 0 4 3 0 0 0 0 1 3 0 1 
		1 3 0 0 1 3 0 0 0 0 0 0 1 3 0 0 0 0 0 0 1 5 0 0 1 5 0 0 1 3 0 1 
		1 3 0 0 1 3 0 0 1 1 1 1 1 1 1 1 1 1 1 1 1 1 1 1 1 3 0 0 1 3 0 1 
		1 3 0 0 1 3 0 0 4 3 3 3 3 3 3 3 1 3 3 3 3 3 3 3 3 3 0 0 1 3 0 1 
		1 3 0 0 1 3 0 0 0 0 0 0 0 0 0 0 1 3 0 0 0 0 0 0 0 0 0 0 1 3 0 1 
		1 3 0 0 1 3 0 0 0 0 0 0 0 0 0 0 1 3 0 0 0 0 0 0 0 0 0 0 1 3 0 1 
		1 3 0 0 1 3 0 0 0 0 0 0 0 0 0 0 1 3 0 0 1 1 5 1 1 5 0 0 1 3 0 1 
		1 3 0 0 1 1 1 1 1 1 5 0 0 1 1 1 1 3 0 0 1 3 3 4 1 3 0 0 4 3 0 1 
		1 3 0 0 4 3 3 3 3 3 3 0 0 4 3 3 3 3 0 0 1 3 1 5 1 3 0 0 0 0 0 1 
		1 3 0 0 0 0 0 0 0 0 0 0 0 0 0 0 0 0 0 0 1 3 4 3 1 3 0 0 0 0 0 1 
		1 1 1 1 1 1 1 1 1 1 1 1 1 1 1 1 1 1 1 1 1 1 1 1 1 1 1 1 1 1 1 1 
	</tiles>
</map>
